福岡県	fukuoka.fgb
静岡県	shizuoka.fgb
岩手県	iwate.fgb
鹿児島県	kagoshima.fgb
兵庫県	hyogo.fgb
宮崎県	miyazaki.fgb
高知県	kochi.fgb
富山県	toyama.fgb
東京都	tokyo.fgb
香川県	kagawa.fgb
京都府	kyoto.fgb
和歌山県	wakayama.fgb
山形県	yamagata.fgb
茨城県	ibaraki.fgb
鳥取県	tottori.fgb
大阪府	osaka.fgb
石川県	ishikawa.fgb
佐賀県	saga.fgb
沖縄県	okinawa.fgb
広島県	hiroshima.fgb
愛知県	aichi.fgb
秋田県	akita.fgb
福島県	fukushima.fgb
栃木県	tochigi.fgb
奈良県	nara.fgb
埼玉県	saitama.fgb
長野県	nagano.fgb
徳島県	tokushima.fgb
群馬県	gunma.fgb
宮城県	miyagi.fgb
愛媛県	ehime.fgb
新潟県	niigata.fgb
三重県	mie.fgb
千葉県	chiba.fgb
山梨県	yamanashi.fgb
岡山県	okayama.fgb
福井県	fukui.fgb
神奈川県	kanagawa.fgb
熊本県	kumamoto.fgb
北海道	hokkaido.fgb
岐阜県	gifu.fgb
青森県	aomori.fgb
大分県	oita.fgb
山口県	yamaguchi.fgb
滋賀県	shiga.fgb
長崎県	nagasaki.fgb
島根県	shimane.fgb